        1111111111111111111111111
        1000000000110000000000001
        1011000001110000000000001
        1001000000000000000000001
111111111011000001110000000000001
100000000011000001110111111111111
11110111111111011 100000000001
11110111111111011 101010010001
11000000110101011 101010010001
10000000000000001 101010010001
10000000000000001 101010010001
11000001110101011 101011110N01
11110111 1110101 1000000000001
11111111 1111111 111111111111