NO ./path_to_the_north_texture
SO ./path_to_the_south_texture
WE ./path_to_the_west_texture
EA ./path_to_the_east_texture

F 220,100,0
C 225,30,0


                                                                                          111
                                                                                          1001
                                                                                           1001
                                                                                            1001
111111111111111111111111111111111111111111111111111111111111111111                           1001
100000000000000000110000000000000000000000000000000000000000000001                            1001
100000000011000001110000000000001111111111111111111111111111111001                             1001
100000000001000000000000000000001       100001               1001                               1001
111111111011000001110000000000001      10011001             1001                                 1001
100000000011000001110111111111111     1001  1001           1001                                   1001
11110111111111011 1000000000W1       1001    1001         1001                                     1001
111101111111110111101000000001      1001      1001       1001                                       1001
100000000000000000000010000001     1001        1001     1001                                         1001
1000000000000000010001000100001   1001          1001   1001                                           1001
10000000000000001 10001000000101 1001            1001 1001                                             1001
11000001110101001 101010100001001001              1001001                                               1001
11110111 1110101 100000000000000001                10001                                                 1001
11111111 1110111 11111111111111111                  111                                                   1001
           101                                                                                             1001
           101                                                                                              1001
           101                                                                                               1001
           101                                                                                                1001
           101                                                                                                 1001
           101                                                                                                  1001
           1011111111111111111111111111111111111111111111111111111111111111111111111111111111111111111111111111111001
           10000000000000000000000000000000000000000000000000000000000000000000000000000000000000000000000000000000001
           111111111111111111111111111111111111111111111111111111111111111111111111111111111111111111111111111111111111